time,Egg,Larve,Pupe,Adult_male,Adult_female,MALE_DD,MALE_DR,MALE_RR
0,252,347,106,273,77,1,1,95
1,623,519,102,159,109,200,3,70
2,159,525,141,199,136,44,19,96
3,619,714,197,202,128,11,53,135
4,742,716,191,249,179,5,45,152
5,961,1134,249,277,202,4,34,211
6,1883,1669,403,432,334,0,34,243
7,2570,2476,608,730,561,0,25,407
8,3968,3509,778,868,771,200,16,514
9,4254,4972,1232,1230,1107,52,73,743
10,6072,6001,1600,1673,1483,10,125,1095
11,7577,6001,1634,1855,1629,2,112,1559
12,8882,6001,1604,1846,1706,0,67,1788
13,7407,6001,1531,1892,1847,0,41,1805
14,8448,6001,1594,2066,1840,0,21,1871
15,8852,6001,1591,1962,1800,200,13,1853
16,9619,6001,1641,1867,1834,51,36,1875
17,8843,6001,1585,1940,1894,12,62,1793
18,7972,6001,1587,1895,1845,0,56,1884
19,9487,6001,1595,1944,1825,0,41,1854
20,8925,6001,1618,1807,1834,0,16,1928
21,8991,6001,1614,2110,1796,0,16,1791
22,8333,6001,1586,1941,1807,200,14,1896
23,8044,6001,1585,1958,1774,37,24,1880
24,8323,6001,1600,1983,1858,6,53,1899
25,9022,6001,1618,1897,1867,2,61,1920
26,8780,6001,1599,1900,1872,1,45,1851
27,8775,6001,1579,1876,1805,1,21,1878
28,8266,6001,1632,2020,1867,0,9,1867
29,7883,6001,1646,1885,1870,200,8,1812
30,8436,6001,1600,1900,1838,52,28,1805
31,8295,6001,1629,1987,1856,12,54,1834
32,9942,6001,1592,1902,1812,3,51,1933
33,8618,6001,1527,1855,1829,1,39,1862
34,7599,6001,1588,1903,1871,1,25,1829
35,8329,6001,1577,2070,1874,0,14,1889
36,8344,6001,1644,1923,1799,200,9,1861
37,10243,6001,1642,1964,1842,43,26,1854
38,8806,6001,1634,1961,1825,10,58,1896
39,7332,6001,1554,1852,1911,1,40,1920
40,8741,6001,1582,1831,1836,0,29,1823
41,10160,6001,1684,1883,1867,0,13,1818
42,9249,6001,1564,2101,1872,0,6,1877
43,8920,6001,1614,1963,1887,200,5,1896
44,9389,6001,1599,1874,1823,51,32,1880
45,8838,6001,1586,1873,1828,13,55,1806
46,8943,6001,1592,1889,1815,4,46,1823
47,9423,6001,1595,1827,1838,2,32,1855
48,9819,6001,1582,1857,1916,0,21,1806
49,8507,6001,1626,2045,1836,0,21,1836
50,9829,6001,1576,1974,1852,200,11,1834
51,9476,6001,1645,1887,1753,61,40,1873
52,8169,6001,1563,1864,1902,6,68,1813
53,8048,6001,1635,1878,1821,3,61,1800
54,9906,6001,1544,1936,1864,0,39,1839
55,8721,6001,1553,1853,1830,0,32,1904
56,9507,6001,1589,2057,1845,0,21,1832
57,8057,6001,1580,2008,1843,200,12,1845
58,8040,6001,1583,1915,1800,55,19,1934
59,9819,6001,1662,1918,1855,18,54,1843
60,9143,6001,1540,1939,1873,4,61,1853
61,8961,6001,1546,1882,1893,1,42,1896
62,8110,6001,1626,1893,1830,0,35,1847
63,8979,6001,1597,2132,1848,0,35,1858
64,8806,6001,1624,1981,1901,200,15,1917
65,10797,6001,1567,1970,1909,43,45,1893
66,7632,6001,1629,1934,1843,11,70,1889
67,9157,6001,1631,1905,1867,0,45,1889
68,8638,6001,1661,1989,1834,0,25,1880
69,9703,6001,1645,1934,1911,0,23,1966
70,7859,6001,1593,2090,1875,0,16,1918
71,7882,6001,1663,1952,1806,200,12,1878
72,8549,6001,1624,1925,1826,39,50,1863
73,8068,6001,1617,1936,1835,7,66,1852
74,7704,6001,1655,1940,1857,0,46,1890
75,9863,6001,1571,1908,1849,0,33,1907
76,7686,6001,1627,1875,1892,0,15,1893
77,10826,6001,1625,2100,1861,0,10,1865
78,9878,6001,1597,1981,1917,200,2,1898
79,8033,6001,1586,1942,1802,41,33,1907
80,7761,6001,1658,1890,1826,13,32,1897
81,8993,6001,1584,1896,1917,5,29,1856
82,9395,6001,1547,1892,1857,1,19,1876
83,8207,6001,1530,1899,1831,0,18,1874
84,9300,6001,1502,2088,1889,0,14,1885
85,8782,6001,1622,1877,1836,200,9,1879
86,9386,6001,1496,1925,1856,51,67,1759
87,8947,6001,1576,1925,1817,11,95,1819
88,9356,6001,1563,1918,1854,3,48,1874
89,8736,6001,1638,1941,1933,2,49,1867
90,8063,6001,1589,1891,1847,1,43,1897
91,9854,6001,1592,2118,1935,1,31,1859
92,8130,6001,1635,1945,1882,200,17,1901
93,8250,6001,1589,1897,1822,47,37,1861
94,8273,6001,1653,1877,1847,8,93,1796
95,8023,6001,1679,1910,1862,1,72,1804
96,8465,6001,1570,1973,1888,0,53,1857
97,8389,6001,1574,1901,1858,0,49,1924
98,9205,6001,1579,2088,1832,0,31,1870
99,8113,6001,1606,1892,1872,200,15,1873
100,8072,6001,1621,1873,1913,43,35,1814
101,8282,6001,1583,1982,1820,12,73,1788
102,8593,6001,1630,1911,1860,2,48,1932
103,8984,6001,1598,1900,1839,0,41,1870
104,8432,6001,1651,1844,1871,0,19,1881
105,7976,6001,1585,2009,1826,0,15,1829
106,8683,6001,1523,1870,1794,200,10,1799
107,8006,6001,1550,1870,1762,53,36,1781
108,7466,6001,1553,1907,1803,12,67,1791
109,8284,6001,1585,1880,1842,2,37,1868
110,9520,6001,1628,1912,1869,0,33,1847
111,8811,6001,1616,1908,1820,0,19,1893
112,9413,6001,1620,2041,1803,0,12,1896
113,8877,6001,1556,1879,1792,200,8,1833
114,8788,6001,1511,1929,1813,38,33,1808
115,8335,6001,1550,1957,1878,13,48,1868
116,8160,6001,1574,1949,1894,4,46,1907
117,9466,6001,1590,1917,1857,1,39,1909
118,10107,6001,1666,1869,1872,0,31,1886
119,9062,6001,1650,2121,1852,0,21,1848
120,9097,6001,1600,1983,1785,200,16,1905
121,9037,6001,1533,1974,1851,42,32,1909
122,9302,6001,1646,1826,1834,6,51,1917
123,9341,6001,1566,1951,1895,1,45,1780
124,9932,6001,1592,1955,1855,0,43,1908
125,8243,6001,1610,1962,1876,0,35,1920
126,8524,6001,1550,2171,1831,0,30,1932
127,7770,6001,1573,1927,1791,200,23,1948
128,8563,6001,1591,1876,1808,44,35,1848
129,9723,6001,1590,1889,1844,14,36,1826
130,7947,6001,1589,1851,1834,4,30,1855
131,8088,6001,1556,1886,1871,1,28,1822
132,9274,6001,1638,1969,1908,0,12,1874
133,10101,6001,1591,2129,1898,0,13,1956
134,8532,6001,1576,2007,1820,200,10,1919
135,9276,6001,1617,1910,1853,44,35,1928
136,8678,6001,1517,1884,1845,11,39,1860
137,8877,6001,1600,1881,1871,1,40,1843
138,9381,6001,1561,1825,1872,0,19,1862
139,6996,6001,1686,1852,1833,0,15,1810
140,8973,6001,1635,2022,1859,0,13,1839
141,8746,6001,1548,1897,1813,200,5,1817
142,9225,6001,1574,1861,1830,52,16,1829
143,8733,6001,1568,1912,1819,10,50,1801
144,8347,6001,1594,1899,1865,2,30,1880
145,7757,6001,1606,1957,1862,1,20,1878
146,7421,6001,1578,1887,1843,0,15,1942
147,8522,6001,1591,2151,1837,0,9,1878
148,8861,6001,1545,1954,1856,200,5,1946
149,8518,6001,1587,1923,1826,44,33,1877
150,8086,6001,1546,1921,1748,10,54,1859
151,9656,6001,1629,1887,1848,1,55,1865
152,7611,6001,1641,1827,1870,0,29,1858
153,7696,6001,1601,1963,1834,0,24,1803
154,8772,6001,1654,2188,1773,0,29,1934
155,7953,6001,1574,1980,1809,200,16,1972
156,8092,6001,1614,1997,1752,51,49,1880
157,8856,6001,1606,1931,1766,15,59,1923
158,8862,6001,1624,1879,1816,4,67,1860
159,8837,6001,1529,1876,1864,0,57,1822
160,7868,6001,1582,1900,1813,0,39,1837
161,8292,6001,1579,2050,1798,0,30,1870
162,9818,6001,1660,1890,1843,200,18,1832
163,8336,6001,1524,1834,1878,36,43,1811
164,7597,6001,1575,1750,1893,3,52,1779
165,8163,6001,1582,1871,1833,0,37,1713
166,9849,6001,1623,1893,1792,0,31,1840
167,8625,6001,1598,1894,1813,0,20,1873
168,8127,6001,1635,2019,1812,0,13,1881
169,10520,6001,1629,1976,1834,200,5,1814
170,8787,6001,1571,1935,1815,50,28,1898
171,8823,6001,1600,1885,1834,10,71,1854
172,9353,6001,1583,1891,1845,0,59,1826
173,10142,6001,1597,1872,1820,0,39,1852
174,9906,6001,1606,1925,1814,0,22,1850
175,9398,6001,1621,1992,1877,0,18,1907
176,8463,6001,1579,1911,1883,200,27,1765
177,8125,6001,1609,1948,1831,48,46,1817
178,8421,6001,1618,1937,1731,8,98,1842
179,7295,6001,1542,1864,1786,1,75,1861
180,9967,6001,1564,1885,1827,0,48,1816
181,10097,6001,1619,1902,1819,0,38,1847
182,9221,6001,1604,2112,1896,0,22,1880
183,8628,6001,1622,1992,1857,200,17,1895
184,10222,6001,1647,1921,1890,52,27,1913
185,8748,6001,1587,1944,1892,10,59,1852
186,10618,6001,1607,1892,1902,0,35,1909
187,10283,6001,1649,1893,1824,0,29,1863
188,8927,6001,1606,1925,1860,0,19,1874
189,9397,6001,1593,2103,1889,0,9,1916
190,9902,6001,1563,1828,1964,200,9,1894
191,9615,6001,1647,1859,1831,42,27,1759
192,10278,6001,1629,1880,1903,13,45,1801
193,9305,6001,1583,1882,1880,2,34,1844
194,8746,6001,1655,1879,1844,0,22,1860
195,11368,6001,1604,1878,1934,0,15,1864
196,9187,6001,1642,2060,1858,0,13,1865
197,9032,6001,1598,1958,1840,200,6,1854
198,8725,6001,1587,1881,1846,48,30,1880
199,8226,6001,1618,1894,1801,10,70,1801
